IGG ID;Name;Rank;Might;Old Might;Might Difference;Kills;Old Kills;Kills Difference;Old Name
1904003311;Valle10;RANK3;164298432;164279745;18687;107076;107076;0;
1800664858;Lau sirstone;RANK3;557386114;557200828;185286;6137999;6137999;0;
1800129182;laUmikeltron;RANK3;650522692;650478816;43876;5539072;5539072;0;
1792262200;Ako ako II;RANK3;170931163;170913497;17666;22961208;22961208;0;
1242670035;Ako Ako 98;RANK3;1080514914;1078987854;1527060;12761764;12761764;0;
1075661724;felipe l pro;RANK3;914386105;912785007;1601098;11038992;11038992;0;
955760825;Serch Lopez;RANK3;608289789;608035989;253800;6429149;6429149;0;
953785923;Checho801;RANK3;1043913076;1043616976;296100;11366065;11366065;0;
900415702;Radhamantyss;RANK3;666889048;666317926;571122;7273091;7273091;0;
898393247;miya musashi;RANK3;771820538;771526214;294324;8432281;8432281;0;
869501957;lordDanny00;RANK3;829759653;829553204;206449;21414133;21414133;0;
812940542;A N D E R D;RANK3;639738241;639314047;424194;48770694;48770694;0;
790057093;Mr Juanzhito;RANK3;312024024;312024024;0;1167762;1167762;0;
782251021;lokokuerdo;RANK3;975236234;975236234;0;41756963;41756963;0;
777540447;Nico Robin26;RANK3;1091205913;1091205913;0;25903949;25903949;0;
776981913;jog2;RANK3;1135705265;1153335461;-17630196;39879685;39879685;0;
770859094;iKarensita;RANK3;304777037;304777037;0;1497410;1497410;0;
768898436;mrbulllzz221;RANK3;428780857;428717257;63600;7059606;7059606;0;
766183317;kvothe 19;RANK3;1000141171;999601171;540000;12907807;12907807;0;
765709482;Karenzitq;RANK3;14661155;14661155;0;3369;3369;0;
763305835;KarenxiTq;RANK3;391082041;391082041;0;20552932;20552932;0;
762350010;zT Tian;RANK3;690099054;690099054;0;69379705;69379705;0;
760762600;omegasclmb;RANK3;1267749123;1267783911;-34788;1679858;1679858;0;
756000274;juligan;RANK3;877665563;877504235;161328;34462561;34462561;0;
728690522;rocky5t;RANK3;612975340;612573340;402000;20272744;20272744;0;
702031414;Heviel;RANK4;1889608440;1889608440;0;586368985;586368985;0;
701939892;F41RYT41L;RANK3;2014792095;2014792095;0;89228338;89228338;0;
701929222;06saske;RANK3;1197681361;1578329629;-380648268;63423388;63423388;0;
699139039;monky120;RANK3;775464452;774503756;960696;23049585;23049585;0;
696890984;arubiac;RANK1;142891925;142891925;0;863276;863276;0;
694641208;DRAKO rc;RANK3;1071383031;1070934087;448944;10820147;10820147;0;
694058607;ES LIA;RANK3;466882791;466835737;47054;203942;203942;0;
688104890;rambito li;RANK1;641672744;641415344;257400;23718041;23718041;0;
676976652;vikingo;RANK3;870719578;870699865;19713;30996546;30996546;0;
672155023;keanelove;RANK5;797598787;797639347;-40560;824097;824097;0;
668681174;ES DSL 20;RANK1;577969348;577554540;414808;633211;633211;0;
665107504;DarkLord 0;RANK3;2399378467;2399354811;23656;252625701;252625701;0;
665026043;Elsin;RANK4;1683621097;1683621097;0;231308034;231308034;0;
664970697;Chema38;RANK3;1886414718;1886258198;156520;53180512;53180512;0;
664333744;sarily;RANK3;1552346073;1552346073;0;13563822;13563822;0;
662512616;shiro128;RANK3;1326488660;1326072740;415920;7509380;7509380;0;
653257909;MF YukariBob;RANK3;1586015057;1586015057;0;89457409;89457409;0;
649979654;mala yerba;RANK3;815895278;815462560;432718;631235;631235;0;
649717056;MF FBI Agent;RANK4;412905127;412725127;180000;1148507;1148507;0;
647480950;Ave Fenix vr;RANK3;1241348215;1241348215;0;21313424;21313424;0;
646701937;Akita v;RANK3;1902095750;1902129782;-34032;121402434;121402434;0;
641096992;ES KIRA 17;RANK1;618142272;617814118;328154;340943;340943;0;
640806262;ES ALE 94;RANK1;607639769;606571520;1068249;755627;755627;0;
634968940;Rey Ali;RANK3;530846852;530191650;655202;33974519;33974519;0;
628865106;XxSeruhioXx;RANK3;1450026574;1449501250;525324;22187282;22187282;0;
615469598;ODIN m;RANK1;1627995852;1628117658;-121806;11193322;11193322;0;
615387242;1e DEMOLEDOR;RANK3;1686451302;1686035574;415728;44904656;44904656;0;
614063899;limite12;RANK3;363202135;362752135;450000;17567401;17567401;0;
612674940;Guenyiar;RANK3;1336005858;1335465858;540000;12817013;12817013;0;
606835404;TWICE OT9;RANK3;769347328;766420012;2927316;13709036;13709036;0;
606089987;1e kalox;RANK4;1975677204;1975765380;-88176;142610886;142610886;0;
602539642;Valroc;RANK3;1282646919;1282471206;175713;26914884;26914884;0;
597915626;ninobravo;RANK3;639957086;639957086;0;28562965;28562965;0;
590319104;LOKI mn;RANK1;566408679;566529167;-120488;23259965;23259965;0;
589740191;Namysam;RANK4;2202241811;2201747651;494160;468069600;468069599;1;
589602357;Darkeysi;RANK3;1027242118;1027573048;-330930;415027326;414419891;607435;
589169919;tony2881;RANK3;651554422;651514422;40000;26832864;26832864;0;
589059900;Javierblan;RANK3;821634768;821630952;3816;6080424;6080424;0;
588954402;1eOmegaclmb;RANK4;2269745117;2269748621;-3504;68165615;68165614;1;
581489282;Pel1;RANK3;1207761295;1207155125;606170;13907695;13907695;0;
579088029;Lord Xing S2;RANK3;655888453;653179716;2708737;20891736;20891736;0;
565074840;Jarlaxe;RANK3;1637590419;1637050419;540000;15911388;15911388;0;
560622667;vihenna00;RANK3;666513581;666457261;56320;23190540;23190540;0;
559361359;MF YukariShi;RANK4;2588655994;2588655994;0;638291323;638291323;0;
552444177;Lugo75;RANK3;948498802;948498802;0;11603991;11603991;0;
551543541;Diasus;RANK3;1303907557;1303332072;575485;55443282;55443282;0;
551082707;Drizztlugo;RANK3;1643227710;1642615710;612000;99124151;99124151;0;
538003199;Wotam;RANK4;1823480644;1822706426;774218;109183199;109165850;17349;
535375506;MF YukariSid;RANK3;1622625870;1622625870;0;33051326;33051326;0;
534065764;LYK3R;RANK3;1077741870;1077575534;166336;98273690;98273690;0;
532590503;ES SANA 62;RANK1;936142039;935941123;200916;3188945;3188945;0;
532114085;ES YOL 63;RANK1;966387119;965760129;626990;1436170;1436170;0;
525641361;torrente2020;RANK3;660108821;660108821;0;29874732;29874732;0;
525415192;falete222;RANK3;679273159;679271447;1712;29036313;29036313;0;
524992292;ES VLC73;RANK3;1276301277;1275234773;1066504;2088765;2088765;0;
517993169;DragonHouse;RANK3;1928333386;1927973386;360000;164840559;164840559;0;
516945027;ES VALLEKA0;RANK4;1700531770;1700403906;127864;6292190;6292190;0;
457513478;libaoo;RANK3;1961415322;1959242460;2172862;722861476;722861476;0;
444728328;limite1;RANK3;457493040;457404048;88992;32735962;32735962;0;
406067661;M14a1;RANK3;1392547842;1397164200;-4616358;169632130;169632130;0;