IGG ID;Name;Rank;Might;Old Might;Might Difference;Kills;Old Kills;Kills Difference;Old Name
1326163584;LEIDYPERLY;RANK2;19630143;19341913;288230;20455;12695;7760;
1103685981;tank food;RANK3;322217280;322093016;124264;2462434;2462434;0;
1094648511;LORDJUAREZ31;RANK3;129990114;129990114;0;128085;128085;0;
975674531;chefsxx;RANK3;785214672;784811196;403476;13586242;13586242;0;
949454072;Mluis179;RANK3;918310139;914867238;3442901;47650764;47650764;0;
949062617;Usi340;RANK3;2014952603;2017533153;-2580550;132741174;132253444;487730;
937941305;MizukiBatman;RANK3;966338293;966476713;-138420;92058837;92058837;0;
918198297;tanquesito;RANK3;665913627;665817627;96000;6424004;6424004;0;
892680229;Asturyors;RANK3;1584085505;1582090273;1995232;313960713;313960713;0;
849811942;Rex M;RANK3;1092044578;1091957667;86911;400598804;400598804;0;
847761572;NewHakuna;RANK3;952368062;951536942;831120;251849181;251849181;0;
846573341;maburro ctm;RANK4;1653401639;1646907785;6493854;191480632;191151393;329239;
844625151;HFime;RANK3;549781629;549722149;59480;8096395;8096395;0;
835099741;Johanssy;RANK3;1043044617;1041210017;1834600;9554761;9554761;0;
827694659;HerNanSCiTo;RANK3;1784570343;1782881315;1689028;94458563;93926714;531849;
824235455;XGod Anubis2;RANK3;393764076;393764076;0;5557349;5557349;0;
817040182;MrFinallBoss;RANK4;1634806657;1634104357;702300;624577323;623760119;817204;
809309200;tatto 20;RANK3;566696195;565713395;982800;83398372;83398372;0;
796997690;XGod Anubis;RANK3;1231484661;1226115417;5369244;144807445;144703951;103494;
791541960;zmmma;RANK3;1901921067;1899431242;2489825;346878463;346074055;804408;
772463969;AlbertoR4;RANK3;299119704;299119720;-16;1425908;1425908;0;
764366507;SK You Daddy;RANK3;1035004516;1031764228;3240288;213076505;213076505;0;
753327750;Granero;RANK3;642591808;642591808;0;5311467;5311467;0;
751696444;Pinotea;RANK3;573658706;573658706;0;22223538;22223538;0;
748858433;AleDussan1;RANK3;654570077;654570077;0;13312698;13312698;0;
748858399;XxXSebastian;RANK3;1373172824;1373172824;0;353566479;353566479;0;
739205877;viejitoo;RANK4;1746463799;1757173277;-10709478;1479560346;1478544218;1016128;
728888893;Espadas Roja;RANK3;39647045;39647045;0;582240;582240;0;
726584831;Europa;RANK3;620033571;620033571;0;104831691;104831691;0;
718218085;que mira bob;RANK3;1260834090;1259620554;1213536;124556283;124556283;0;
707005887;Im The SOUL;RANK3;856604008;856089409;514599;431803687;431803687;0;
702239037;IrvinSM;RANK3;499923488;500101976;-178488;6616685;6616685;0;
694876933;maltacnhuevo;RANK3;1006981764;1006981764;0;82360470;82360470;0;
678137938;AQUELARRE;RANK3;1110935633;1110935633;0;79701477;79701477;0;
672413075;Rasmus 1;RANK3;484577031;484092531;484500;13846240;13846240;0;
663777283;ELDEMONIX;RANK3;1679149988;1678569988;580000;630132475;630132475;0;
662280632;khathalina;RANK3;999172032;999028032;144000;3981797;3981797;0;
655921445;IrvinSM26;RANK3;1037228702;1030784342;6444360;213561995;213561995;0;
655010613;chuky01;RANK3;1303709980;1303440880;269100;67151688;67151688;0;
651885950;patasola;RANK3;735131849;731500870;3630979;28287668;28287668;0;
645708235;patagona;RANK3;946956242;946660322;295920;23337734;23337734;0;
630341892;C0NEJ0;RANK3;279221461;279221461;0;784690;784690;0;
624903095;Shinitenshy;RANK4;1297746706;1297536326;210380;489222056;489169799;52257;
624602047;Chilotit;RANK3;875924009;875878369;45640;4805706;4805706;0;
622191815;rey d3monio;RANK4;218913173;218901173;12000;680808;680808;0;
607413069;khathaleya;RANK3;1001985120;1001903994;81126;4728491;4728491;0;
585650306;ESPIAME ESTA;RANK4;1201145142;1201145142;0;74772196;74772196;0;
584380599;AlbertoR2;RANK4;472104865;472015905;88960;16299451;16299451;0;
581678141;MamaSesta;RANK4;1248490636;1248723834;-233198;89173908;89060195;113713;
581670059;XxLadySilxX;RANK3;722787611;722757157;30454;50231517;50231517;0;
578070951;SANTYYY;RANK3;694614343;694827895;-213552;3401419;3401419;0;
576251888;Selene86;RANK3;466238955;466389327;-150372;11271813;11271813;0;
576004265;Duncans chef;RANK3;1537954916;1536752664;1202252;23568719;23568719;0;
575588030;xx nico xx;RANK3;368750011;368750011;0;14049534;14049534;0;
575170344;sir bastiann;RANK3;865081234;863802034;1279200;4805162;4805162;0;
575112757;Alberto R1;RANK3;493100358;492488145;612213;16044623;16044623;0;
575042041;XxPerlyxX;RANK3;713851428;713610492;240936;11738755;11738755;0;
567034330;lord tanquex;RANK3;917585531;917088731;496800;10969614;10969614;0;
565644164;Meikobato;RANK3;189007166;189005566;1600;5036343;5036343;0;
563483698;Real g4;RANK3;698103594;698103594;0;81732164;81732164;0;
562681573;XxLucy16xX;RANK4;280062213;280062213;0;29672;29672;0;
558410518;XxYurikoxX;RANK5;1305554220;1303641286;1912934;180516556;180096366;420190;
557623431;licantropo;RANK4;1322178848;1322074848;104000;75236271;75236271;0;
556904547;X Psycho xX;RANK3;610511599;610511599;0;92380418;92380418;0;
555262823;zx601;RANK3;827838936;827258936;580000;16857879;16857879;0;
547863342;NoMolestarX;RANK3;312093600;312072576;21024;31745410;31745410;0;
546955595;anjomal 1;RANK3;858275234;858275234;0;33961901;33961901;0;
543842693;vanesi;RANK3;1003687506;1003605797;81709;6793876;6793876;0;
543814578;1Vannessa;RANK3;1273612340;1272244749;1367591;5345663;5345663;0;
509121918;EL COLOSO;RANK3;861395515;861395515;0;58768626;58768626;0;
468050803;In The Soul;RANK2;489858378;489858378;0;88629174;88629174;0;
463937090;Coyhaiquina;RANK3;1243548247;1242712339;835908;23487210;23487210;0;
461628858;Super Tank;RANK4;1366407050;1368632606;-2225556;53125895;52704459;421436;
446138590;Lady Vamp8;RANK4;1297406061;1297212061;194000;17859719;17859719;0;
436226230;MALEFICO;RANK3;486950180;486802924;147256;43711764;43711764;0;
430980593;XxCHUKYxX;RANK4;1423324984;1421682880;1642104;914473944;913952337;521607;
408630761;NARUTOSHINPU;RANK3;1171121612;1169830201;1291411;72139649;72139649;0;
402264140;terror xtrem;RANK3;891775039;891485839;289200;96875280;96875280;0;
400641116;TANQUE GM;RANK3;1401811077;1408937549;-7126472;296935704;296832210;103494;
397453130;N1ppur;RANK4;2265594433;2267455337;-1860904;387578416;386791330;787086;
396515097;Giann0;RANK4;1048881537;1048919095;-37558;86893263;86893263;0;
377334783;WUQINGXY;RANK3;463608066;477676072;-14068006;32567447;32540496;26951;
368801815;x Rey lobo x;RANK3;911880452;911849128;31324;79262665;79262665;0;
368000441;RT020;RANK3;460762644;460831840;-69196;18491093;18490253;840;
366392691;Ever rich;RANK3;1449043128;1449013128;30000;44067635;44067635;0;
360517277;WU El CAPO;RANK3;1427641404;1427641404;0;144175472;144175472;0;
355381625;BenTor;RANK3;843801608;843437720;363888;11273913;11273913;0;
340020311;Al3xander97;RANK4;1257317826;1248377826;8940000;239551924;239551924;0;
337887912;lllTANGOlll;RANK3;1633312784;1633312784;0;162159836;162159836;0;
336267460;EL ALEMAN;RANK3;2373229851;2372181851;1048000;333709989;333709989;0;
334814436;CarlosMan;RANK3;1033093206;1030263750;2829456;159938849;159938849;0;
320352921;XxDuffmanxX;RANK4;1503039966;1500271447;2768519;576919594;575773508;1146086;
315261871;Aaddrriiaann;RANK3;1019592637;1019592637;0;101731414;101731414;0;
308914455;PiKaBossQ4;RANK3;815866101;815769461;96640;26505772;26505772;0;
289564205;rata asesina;RANK3;1039234840;1039234842;-2;242231351;242231351;0;
241102972;f2pPiKaBoss;RANK3;1553267448;1543565838;9701610;586163704;586163704;0;