IGG ID;Name;Rank;Might;Old Might;Might Difference;Kills;Old Kills;Kills Difference;Old Name
1830420196;Chin Dafnn;RANK2;236585590;236576950;8640;532152;532152;0;
1332726248;Sakuron;RANK2;1201440273;1201488117;-47844;6428957;6428957;0;
1328976539;sakurito;RANK2;1892222039;1891565903;656136;60752113;60752113;0;
1271389452;xWalkerW10x;RANK2;629607140;629605440;1700;17324;17324;0;
1271389449;xWalkerW09x;RANK2;628799180;628772480;26700;34448;34448;0;
1271388783;xWalkerW08x;RANK2;627896133;627894433;1700;47964;47964;0;
1271388743;xWalkerW07x;RANK2;628650008;628648308;1700;29240;29240;0;
1271388715;xWalkerW06x;RANK2;628874258;628872558;1700;13315;13315;0;
1271365281;xWalkerS04x;RANK2;629004808;628978108;26700;7354;7354;0;
1271365250;xWalkerS05x;RANK2;629251141;629249441;1700;18764;18764;0;
1271365142;xWalkerS03x;RANK2;629178161;629151461;26700;22966;22966;0;
1271365117;xWalkerS02x;RANK2;629011528;628984828;26700;6455;6455;0;
1271365113;xWalkerS01x;RANK2;629478249;629476249;2000;8914;8914;0;
1218827033;Chamgadad;RANK2;558193887;556037396;2156491;7716984;7716984;0;
1214959089;Sargentoooo;RANK2;770982260;763962356;7019904;3607054;3607054;0;
1098924554;valencano 13;RANK2;724875272;725547365;-672093;8819589;8819589;0;
1087033727;venus star;RANK2;260451119;260451119;0;21059;21059;0;
928523397;KB Ares I;RANK3;459932261;459839861;92400;1713779;1713779;0;
911835706;pegasus30;RANK2;773015369;772475369;540000;80344230;80344230;0;
826048414;Conejito2306;RANK2;1493388502;1413047278;80341224;279690542;279690542;0;
798745125;Azul16X;RANK2;800620547;800620547;0;5738260;5738260;0;
775895565;CRISTIAN CT;RANK2;542482485;542151716;330769;4930745;4930745;0;
766707663;TheLaPlanta;RANK2;705819472;705819472;0;8598874;8598874;0;
747751737;cyntu;RANK4;1683168764;1682529464;639300;126957307;126957307;0;
735770009;Johan0311;RANK2;1475380303;1474391760;988543;40656444;40656444;0;
728008821;MalcriadittA;RANK3;1007468503;1007468503;0;46616726;46616726;0;
727539438;Dkno25;RANK2;983698352;983650352;48000;107040010;107040010;0;
704281726;Edrian;RANK2;1111117361;1110294993;822368;22474789;22474789;0;
701803552;QueenDramaa;RANK4;1462557441;1462587789;-30348;53533593;53533593;0;
699616405;ooVaS010oo;RANK1;1954376225;1954567665;-191440;3112866;3112866;0;
699615914;ooVaS007oo;RANK1;1958293543;1958492471;-198928;5537740;5537740;0;
699615845;ooVaS009oo;RANK1;1978141382;1978320690;-179308;6176798;6176798;0;
699615715;ooVaS008oo;RANK1;1962885698;1963077750;-192052;8688152;8688152;0;
699615662;ooVaS006oo;RANK1;1968331058;1968528906;-197848;5106014;5106014;0;
699600536;ooVaS003oo;RANK1;1949618119;1949699151;-81032;24804463;24804463;0;
699600401;ooVaS002oo;RANK1;1948931253;1949022421;-91168;5410000;5410000;0;
699600237;ooVaS005oo;RANK1;1947495992;1947653008;-157016;17728169;17728169;0;
699600230;ooVaS004oo;RANK1;1980749467;1980910727;-161260;17556422;17556422;0;
699590989;ooVaS001oo;RANK1;1961251628;1961417724;-166096;29491862;29491862;0;
687037882;El Dorado;RANK4;647026910;646910990;115920;1413706;1413706;0;
686099078;Darkgreen;RANK4;933853392;933853392;0;52892990;52892990;0;
681257144;JUANPE;RANK3;2046366363;2046219228;147135;67575504;67575504;0;
672088260;Dark Mundo;RANK4;1614737260;1614577496;159764;232745564;232745564;0;
665549405;giackrox;RANK2;1984462093;1984462093;0;211843589;211843589;0;
659448922;Mitchell 02;RANK2;1285863471;1284927471;936000;2453820;2453820;0;
658113211;Michis95;RANK2;1040321578;1037741226;2580352;62933207;62933207;0;
653763973;Fifi fifone;RANK4;1712192425;1711939309;253116;261434737;261434737;0;
649378702;Jhoni1;RANK2;845395377;844744637;650740;17588947;17588947;0;
646441942;el rey montc;RANK2;1848159188;1848159188;0;173822438;173822438;0;
646349957;XxMGSxX;RANK2;1794548168;1794209321;338847;78088205;78088205;0;
645515706;Analuu;RANK3;1424306153;1423533953;772200;37357195;37357195;0;
634025093;valigolo02;RANK1;944899831;944899831;0;23144402;23144402;0;
632059507;manu gocho;RANK2;691508876;691090420;418456;12554922;12554922;0;
631695724;Jedimester;RANK1;828149818;828148118;1700;1294341;1294341;0;
619775777;JesVGod;RANK1;1301856903;1301276903;580000;85174038;85174038;0;
618124236;illidain;RANK3;1432557459;1432557459;0;126242315;126242315;0;
590822297;ASTERIS7;RANK2;649145885;649144501;1384;521022;521022;0;
588248851;valigolo;RANK2;955145050;955135924;9126;21055957;21055957;0;
579115818;Felipe8;RANK4;789206230;789028630;177600;4452069;4452069;0;
576773217;99 A MAN;RANK3;3257705139;3257609283;95856;412081855;412081855;0;
573727599;Jeska33;RANK2;1444744134;1443340134;1404000;214188372;214188372;0;
564756957;colosoVX;RANK2;1073002064;1073013900;-11836;483819228;483819228;0;
562040476;0RickHunter0;RANK4;252725170;252659196;65974;6626488;6626488;0;
556628743;Soy Sami;RANK2;844499660;844499660;0;14156655;14156655;0;
548470975;Navi Neytiri;RANK4;1231742232;1231541112;201120;8562525;8562525;0;
543574138;RoyFocker01;RANK4;2025723131;2025634186;88945;472338189;472338189;0;
543536478;Juan 7777777;RANK4;1532013300;1531385300;628000;839548381;839548381;0;
543013733;Fernando1984;RANK3;1984916992;1984604184;312808;587871059;587871059;0;
531603934;JustLau;RANK4;1370226667;1370226667;0;32046708;32046708;0;
527850333;FedEx2021;RANK4;1931870998;1931714998;156000;327196932;327196932;0;
527571135;Matias8;RANK5;2192235849;2191629573;606276;1035455657;1035455657;0;
527258995;Dovux;RANK3;1777770548;1777126548;644000;396743633;396743633;0;
522130170;Campanula13;RANK4;1630542308;1630694384;-152076;159280728;159280728;0;
517552301;Kuuuushhhh;RANK2;1567419958;1567419958;0;130576522;130576522;0;
505302369;Liiiin;RANK2;3005229531;3005229531;0;476073249;476073249;0;
469048815;Ashnyk;RANK4;1221200005;1221126621;73384;37030805;37030805;0;
446564417;Takki85;RANK2;863719856;863668856;51000;10297468;10297468;0;
436361778;Dariiooo;RANK4;1575815464;1575599014;216450;360778335;360778335;0;
436023142;Miss Lake;RANK4;1857290451;1857186451;104000;652157670;652157670;0;
431325262;MenteMaestra;RANK4;1353093864;1352963864;130000;36651392;36651392;0;
429963525;RAIBACK;RANK2;1021837957;1021148789;689168;32623852;32623852;0;
428954168;Athos91;RANK4;480559894;480463894;96000;118451898;118451898;0;
419071630;XxFluffyDom;RANK2;1619831025;1618791654;1039371;100201094;100201094;0;
418916566;S O F l A;RANK3;1303772193;1303772193;0;39337704;39337704;0;
410376152;ryckzolea;RANK2;1081385693;1080740638;645055;4571116;4571116;0;
407761145;LadyAzul29;RANK2;1067852681;1067787065;65616;33151140;33151140;0;
397325214;Sr Barrigon;RANK4;795335594;795305094;30500;15423006;15423006;0;
340479367;lBerrinchesl;RANK4;479043387;479009387;34000;52500042;52500042;0;
334641435;NASHA MUERTE;RANK4;1376132013;1376036821;95192;288793400;288793400;0;
329944274;Espartajesus;RANK2;2324561015;2324561015;0;260365665;260365665;0;