IGG ID;Name;Rank;Might;Old Might;Might Difference;Kills;Old Kills;Kills Difference;Old Name
1802398262;Huerta V;RANK2;96917695;96917761;-66;81427;81427;0;
1656236148;HUERTA IV;RANK2;303610397;303610527;-130;3479309;3479309;0;
1332726248;Sakuron;RANK2;1052786730;1052786730;0;7522056;7522056;0;
1328976539;sakurito;RANK2;1945521822;1945521822;0;60817729;60817729;0;
1319872559;FANTA UVA;RANK2;809630845;809953513;-322668;19426832;19426832;0;
1271389452;xWalkerW10x;RANK2;666176174;666150574;25600;17324;17324;0;
1271389449;xWalkerW09x;RANK2;665585514;665583914;1600;34460;34460;0;
1271388783;xWalkerW08x;RANK2;664131767;664106167;25600;47964;47964;0;
1271388743;xWalkerW07x;RANK2;664751142;664725542;25600;29240;29240;0;
1271388715;xWalkerW06x;RANK2;664967492;664911892;55600;13315;13315;0;
1271365281;xWalkerS04x;RANK2;665518510;665468910;49600;7354;7354;0;
1271365250;xWalkerS05x;RANK2;665446075;665408475;37600;18764;18764;0;
1271365142;xWalkerS03x;RANK2;664928395;664914795;13600;22966;22966;0;
1271365117;xWalkerS02x;RANK2;665587826;665526226;61600;6455;6455;0;
1271365113;xWalkerS01x;RANK2;665682929;665657329;25600;8914;8914;0;
1218827033;Chamgadad;RANK2;676576096;676044130;531966;7717002;7717002;0;
1214959089;Sargentoooo;RANK2;870034484;870034484;0;3607054;3607054;0;
1209167800;Sargento;RANK2;733423491;732885291;538200;27828638;27828638;0;
1208113955;HUERTA III;RANK2;820234625;820162625;72000;86343186;86343186;0;
928523397;KB Ares I;RANK3;476252064;476159664;92400;1713779;1713779;0;
846482624;Natanael 03;RANK2;618829857;781820297;-162990440;15813378;15403533;409845;
766707663;TheLaPlanta;RANK2;717360753;717360753;0;8598874;8598874;0;
747751737;cyntu;RANK4;1730293155;1729720299;572856;130034723;130034723;0;
735770009;Johan0311;RANK2;1532663961;1532663961;0;43192703;43192703;0;
728008821;MalcriadittA;RANK3;995386109;995622469;-236360;49504157;49504157;0;
727539438;Dkno25;RANK2;1012125352;1012125352;0;107040010;107040010;0;
701803552;QueenDramaa;RANK4;1414690122;1363477308;51212814;59073412;59073412;0;
699616405;ooVaS010oo;RANK2;2066766145;2066085996;680149;3112866;3112866;0;
699615914;ooVaS007oo;RANK2;2074464342;2073863501;600841;5537740;5537740;0;
699615845;ooVaS009oo;RANK2;2092760093;2092159252;600841;6176798;6176798;0;
699615715;ooVaS008oo;RANK2;2077014731;2076335566;679165;8688152;8688152;0;
699615662;ooVaS006oo;RANK2;2085277524;2084676683;600841;5106014;5106014;0;
699600536;ooVaS003oo;RANK2;2068492798;2067951098;541700;24804463;24804463;0;
699600401;ooVaS002oo;RANK2;2063092444;2062474124;618320;5410000;5410000;0;
699600237;ooVaS005oo;RANK2;2062071020;2061529320;541700;17728169;17728169;0;
699600230;ooVaS004oo;RANK2;2093255717;2092714017;541700;17556422;17556422;0;
699590989;ooVaS001oo;RANK2;2088646811;2088105111;541700;29491862;29491862;0;
687037882;El Dorado;RANK4;649558291;649439731;118560;1413736;1413736;0;
686099078;Darkgreen;RANK4;972945416;969796099;3149317;53165408;53165408;0;
681257144;JUANPE;RANK3;2104110807;2104006807;104000;67586802;67586802;0;
672088260;Dark Mundo;RANK5;1660088784;1657336636;2752148;233788333;233788333;0;
665549405;giackrox;RANK2;1665731651;1665731651;0;228569532;228569532;0;
658113211;Michis95;RANK2;1089825829;1089753829;72000;62933229;62933229;0;
653763973;Fifi fifone;RANK4;1767038099;1766931784;106315;262744660;262744660;0;
649378702;Jhoni1;RANK2;758749546;758749546;0;19161430;19161430;0;
646441942;el rey montc;RANK2;1910804667;1905771867;5032800;173822438;173822438;0;
646349957;XxMGSxX;RANK2;1831414937;1830594477;820460;78088205;78088205;0;
645515706;Analuu;RANK3;1439357780;1439357780;0;37357195;37357195;0;
631695724;Jedimester;RANK2;868697225;868695625;1600;1294341;1294341;0;
618124236;illidain;RANK3;1469093979;1468963459;130520;126370027;126370027;0;
590822297;ASTERIS7;RANK2;654950130;654434486;515644;523759;523759;0;
579115818;Felipe8;RANK4;904946287;904768687;177600;4471850;4471850;0;
576773217;99 A MAN;RANK3;3419923415;3414519756;5403659;419856063;419856063;0;
573727599;Jeska33;RANK2;1206879762;1137783230;69096532;220273228;220273228;0;
562040476;0RickHunter0;RANK4;266876878;266670904;205974;7104225;7104225;0;
556628743;Soy Sami;RANK2;828357781;823326935;5030846;14902800;14902800;0;
548470975;Navi Neytiri;RANK4;1270918991;1270192991;726000;8573492;8573492;0;
545102236;Ninja Soul;RANK2;240287316;240287316;0;1385403;1385403;0;
543574138;RoyFocker01;RANK4;2135983951;2130900706;5083245;473909341;473906846;2495;
543536478;Juan 7777777;RANK4;1615945143;1615932231;12912;839604906;839604906;0;
543013733;Fernando1984;RANK3;2054846016;2049961767;4884249;589054052;589054052;0;
539752687;XAkelarreX;RANK2;820044635;820044635;0;198684901;198684901;0;
531603934;JustLau;RANK4;1413193712;1412497712;696000;32046708;32046708;0;
527850333;FedEx2021;RANK4;1972242003;1971521003;721000;327196932;327196932;0;
527571135;Matias8;RANK4;2255821208;2255821208;0;1041087689;1041087689;0;
522130170;Campanula13;RANK4;1657291755;1657975791;-684036;159280740;159280740;0;
505302369;Liiiin;RANK3;3038095844;3038095844;0;476246944;476246944;0;
469048815;Ashnyk;RANK4;1253118024;1252504199;613825;37462787;37462787;0;
446564417;Takki85;RANK2;916349667;916193667;156000;10320329;10320329;0;
436060577;DULCE MUERT3;RANK1;1635023645;1634595629;428016;2011441154;2011441154;0;
436023142;Miss Lake;RANK4;1896989961;1896345961;644000;652160405;652160405;0;
431325262;MenteMaestra;RANK4;1405546005;1404850005;696000;36651905;36651905;0;
429963525;RAIBACK;RANK2;1041935999;1040244499;1691500;33113244;33113244;0;
418916566;S O F l A;RANK1;1401809198;1397525939;4283259;39338469;39338469;0;
410376152;ryckzolea;RANK2;1109377763;1108329763;1048000;4571745;4571745;0;
397325214;Sr Barrigon;RANK4;811855008;811855008;0;15423006;15423006;0;
340479367;lBerrinchesl;RANK4;492833975;492833975;0;52542191;52542191;0;
335059435;MENDoZITA;RANK2;647837141;647826017;11124;7754219;7754219;0;
334641435;NASHA MUERTE;RANK4;1474696411;1474623411;73000;288795631;288795631;0;
321256428;MUERT3 DULC3;RANK2;1035185815;1035185815;0;156758612;156758612;0;