IGG ID;Name;Rank;Might;Old Might;Might Difference;Kills;Old Kills;Kills Difference;Old Name
1960755471;carloso007;RANK2;50619817;50190958;428859;1129146;1129146;0;
1942772588;coco crocodi;RANK2;154188797;154139169;49628;281636;281636;0;
1906626269;BotFrankii;RANK2;115272908;115268920;3988;29772;29772;0;
1810344189;iguanilla;RANK2;53503350;53510958;-7608;1540;1540;0;
1802026617;canitaman;RANK2;26532946;26482505;50441;33850;33850;0;
1651909665;1Tamy;RANK4;793254584;792529186;725398;10965864;10965864;0;
1461738037;EL ANONIMO1;RANK2;111042404;111000473;41931;962986;962986;0;
1358062807;El superTamy;RANK2;366247009;366247009;0;21287005;21287005;0;
1356548453;khalidtortue;RANK3;510590790;510374790;216000;3425141;3425141;0;
1310974438;ANTHONY 30;RANK3;314507520;313657128;850392;9338726;9338726;0;
1284609497;Davidllll;RANK2;337452019;337362419;89600;65114313;65114313;0;
1215961243;ArMaN 10;RANK4;1197388704;1197150856;237848;14687791;14687791;0;
1208391868;solitario 00;RANK2;60731351;60646413;84938;695688;695688;0;
1201021682;Raptor1221;RANK2;550687249;550597249;90000;7019303;7019303;0;
1095429556;aluvion;RANK3;704848187;704522429;325758;8241867;8241867;0;
1042659181;LadyMdusa;RANK4;589671754;589567504;104250;3047307;3047307;0;
967084961;Lord Chars;RANK4;854848789;854848789;0;23842304;23842304;0;
956462819;XkingLuisX2;RANK2;4112384;4109549;2835;42501;42501;0;
953561080;Fernando1x;RANK2;472006558;472001558;5000;10776295;10776295;0;
947675815;hector 1234;RANK4;625491968;624756362;735606;10704227;10704227;0;
938003679;Javit08;RANK4;1171431037;1170867169;563868;50935573;50935573;0;
929178567;carlos0007;RANK2;524683599;529175171;-4491572;37978929;37952268;26661;
923597524;REYDELNORTE;RANK4;865384449;865210401;174048;38643332;38643332;0;
905196019;khalidcroc;RANK4;1737880368;1727630900;10249468;121353518;121353518;0;
886071142;AtamiZeta;RANK4;1403080324;1402540324;540000;262357521;262357521;0;
884002209;sol lit;RANK4;517401352;517468276;-66924;4151032;4151032;0;
813803013;StealBoy;RANK2;764407491;764407491;0;95178273;95178273;0;
809898713;sr biilz;RANK2;292562236;292560846;1390;56050389;56050389;0;
794334307;banko faw;RANK2;442934071;442934071;0;32178507;32178507;0;
791448103;Donisaac;RANK4;1516642929;1516071353;571576;4722601;4722601;0;
783901704;PEKA FAW;RANK4;1067539204;1067521204;18000;240603170;240603170;0;
778372342;Devis;RANK4;536852769;536640025;212744;1236445;1236445;0;
768757451;KRATOS FAW;RANK2;447973043;437932704;10040339;61919478;61919478;0;
768446678;nenocoketo 9;RANK4;632300084;630655645;1644439;10841030;10841030;0;
761134038;Mefistopolis;RANK3;1384247277;1384039277;208000;644188266;644188266;0;
758937192;XkingLuisX1;RANK2;492774460;492671806;102654;34405686;34405686;0;
752871791;alex160895;RANK2;563836414;548601015;15235399;11859009;11859009;0;
733895990;Helena I;RANK4;499025544;498929108;96436;2234314;2234314;0;
711013020;Gezarius;RANK2;592459972;590852789;1607183;32593586;32593586;0;
709053949;Alejandro 95;RANK4;1092806425;1088567679;4238746;25052160;25052160;0;
702537532;SATANAS A;RANK4;1794014648;1785373060;8641588;189294709;189283240;11469;
692580653;xTROSSx;RANK4;1464037179;1463879199;157980;118642537;118642537;0;
688436236;Reina I;RANK4;775218707;774516777;701930;7999501;7999501;0;
688435792;ElenadTroya;RANK4;605659674;605583263;76411;4549714;4549714;0;
680613370;StockHolms;RANK2;208286638;208286638;0;3042535;3042535;0;
673818078;ReinadHielo;RANK3;565865061;565861461;3600;2419039;2419039;0;
667175085;Carl0s007;RANK4;1267244270;1267244270;0;38205193;38205193;0;
666067604;XkingLuisX3;RANK2;85276881;85250772;26109;1414536;1414536;0;
663102130;Dhanielo;RANK4;800929959;800929959;0;27506925;27506925;0;
647014343;flamenking;RANK4;1643424121;1643108149;315972;100750030;100750030;0;
642108191;XkingLuisX;RANK4;992904328;992025596;878732;198429204;198429204;0;
639485490;Mustafunk;RANK3;957424936;956861199;563737;31484775;31484775;0;
635430899;PunisherIsma;RANK4;166482128;166476128;6000;138445;138445;0;
634665528;camaleonking;RANK4;1259949567;1259949567;0;139801829;139801829;0;
633270360;Y U K O N;RANK2;1047543076;1047705474;-162398;253461489;253442955;18534;
631001564;ISalvatoreI;RANK4;537953711;517437275;20516436;4697933;4697933;0;
628506766;alee33;RANK2;464846188;464840587;5601;4374635;4374635;0;
617488437;ELMEXICANO;RANK4;921085100;920364659;720441;22636655;22636655;0;
610695403;Aldemar C;RANK3;424707600;424460724;246876;14365054;14365054;0;
609941980;Thiaguiito;RANK4;1183566891;1183210635;356256;89295998;89295998;0;ReyMeliiioda
609098249;Kurusaki 10;RANK3;438104040;437985520;118520;121873855;121873855;0;
608075191;Bank M0RIA;RANK4;608589497;591313501;17275996;116445744;116445744;0;
604038259;Andres37;RANK2;562307593;561032533;1275060;4412140;4412140;0;
603519552;Aalexa12;RANK2;624708630;624705989;2641;37785913;37785913;0;
602791441;Ammy02;RANK2;831541498;830933100;608398;145698900;145698900;0;
602123489;valee   22;RANK4;963854101;963738530;115571;25352929;25352929;0;
595587844;A SAD 1;RANK3;609625352;609625352;0;12373798;12373798;0;
594179527;Sir Enerway;RANK4;1084783537;1084834981;-51444;48776314;48776314;0;
594165583;Salva100;RANK5;1109021087;1108449891;571196;304848130;304848130;0;
593978582;Jobolu;RANK4;1504785904;1504785904;0;291071543;291071543;0;
590451722;GrossSturm;RANK2;783126373;783126373;0;136518142;136518142;0;
586593035;Coronel10;RANK4;1015336841;1014909906;426935;66655705;66655705;0;
574030457;DanTaliano;RANK2;596735597;596735597;0;145054915;145054915;0;
567827558;solreina;RANK4;1004249300;1003995771;253529;19735067;19735067;0;
566611896;x IGUANA x;RANK4;1044776111;1044739260;36851;224699822;224699822;0;
563001076;IISL4iF3RII;RANK4;1558535848;1557955848;580000;224157134;224157134;0;
553549765;REY LAGARTO;RANK4;1293615023;1293459247;155776;1059438990;1059438990;0;
546764362;tumamaentaga;RANK2;548495184;547118416;1376768;180789328;180789328;0;
543035653;Spencer 98;RANK4;1153958909;1153378909;580000;775923391;775923391;0;
535011262;Fijeron;RANK2;258659441;258659441;0;10003487;10003487;0;
505950872;3l gladiador;RANK4;1509846523;1509846466;57;648620174;648620174;0;
472571055;angelo98981;RANK4;1231223228;1231223171;57;369510570;369510570;0;
467025259;Javier 1313;RANK4;849127893;845151610;3976283;25118680;25118680;0;
463632514;brantee;RANK4;1324950394;1324950388;6;453599990;453599990;0;
446107237;Thanoz C;RANK4;1196837278;1196625600;211678;27744667;27744667;0;
444338156;Platanito323;RANK4;793929601;788880226;5049375;208995660;208995660;0;
431737484;Papox;RANK4;1351547376;1351547376;0;224429219;224429219;0;
401676719;JULIO CSAR 3;RANK3;577333806;577333806;0;13464174;13464174;0;
400339463;gelhidro;RANK4;1675581736;1673793070;1788666;281296599;281296599;0;
381821409;Pitbull king;RANK4;1668978147;1668242147;736000;78479979;78479979;0;
329959173;V KuRaMa V;RANK4;837434487;841189767;-3755280;897775089;897367428;407661;
315971442;Belly Dancer;RANK4;1185685267;1185649782;35485;27125751;27125751;0;